1 1 1 1 1 1 1 1 1 1 1 1 1 1 1 1 1 1 1 1 1 1 1 1 1 1 1 1 1 1 1 1 1 1 1 1 1 1 1 1 1 1 1 1 1 1 1 1 1 1 1 1
1 1 1 1 1 1 1 1 1 1 1 1 1 1 1 1 1 1 1 1 1 1 1 1 1 1 1 1 1 1 1 1 1 1 1 1 1 1 1 1 1 1 1 1 1 1 1 1 1 1 1 1
1 1 1 1 0 0 0 0 0 0 0 0 0 0 0 0 0 0 0 0 0 0 0 0 0 0 0 0 0 0 0 0 0 0 0 0 0 0 0 0 0 0 0 0 0 0 0 0 1 1 1 1
1 1 1 1 0 6 10 10 10 10 2 2 10 10 10 10 9 0 1 0 6 10 10 10 10 2 2 10 10 10 10 9 0 1 0 6 10 10 10 10 2 2 10 10 10 10 9 0 1 1 1 1
1 1 1 1 0 4 1 1 1 1 1 1 1 1 1 1 5 0 1 0 4 1 1 1 1 1 1 1 1 1 1 5 0 1 0 4 1 1 1 1 1 1 1 1 1 1 5 0 1 1 1 1
1 1 1 1 0 4 1 1 1 1 1 1 1 1 1 1 5 0 1 0 4 1 1 1 1 1 1 1 1 1 1 5 0 1 0 4 1 1 1 1 1 1 1 1 1 1 5 0 1 1 1 1
1 1 1 1 0 7 11 11 11 11 3 3 11 11 11 11 8 0 1 0 7 11 11 11 11 3 3 11 11 11 11 8 0 1 0 7 11 11 11 11 3 3 11 11 11 11 8 0 1 1 1 1
1 1 1 1 0 0 0 0 0 0 0 0 0 0 0 0 0 0 0 0 0 0 0 0 0 0 0 0 0 0 0 0 0 0 0 0 0 0 0 0 0 0 0 0 0 0 0 0 1 1 1 1
1 1 1 1 0 1 0 1 0 1 0 1 0 1 1 0 1 0 1 0 1 0 1 0 1 0 1 0 1 1 0 1 0 1 0 1 0 1 0 1 0 1 0 1 1 0 1 0 1 1 1 1
1 1 1 1 0 0 0 0 0 0 0 0 0 0 0 0 0 0 0 0 0 0 0 0 0 0 0 0 0 0 0 0 0 0 0 0 0 0 0 0 0 0 0 0 0 0 0 0 1 1 1 1
1 1 1 1 0 1 1 1 0 1 0 6 10 10 10 10 2 2 10 10 10 10 9 0 1 0 6 10 10 10 10 2 2 10 10 10 10 9 0 1 0 6 10 2 2 10 9 0 1 1 1 1
1 1 1 1 0 1 1 1 0 1 0 12 1 1 1 1 1 1 1 1 1 1 13 0 1 0 12 1 1 1 1 1 1 1 1 1 1 13 0 1 0 12 1 1 1 1 13 0 1 1 1 1
1 1 1 1 0 1 1 1 0 0 0 12 1 1 1 1 1 1 1 1 1 1 13 0 0 0 12 1 1 1 1 1 1 1 1 1 1 13 0 0 0 12 1 1 1 1 13 0 1 1 1 1
0 0 0 0 0 1 1 1 0 1 0 4 1 1 1 1 1 1 1 1 1 1 5 0 1 0 4 1 1 1 1 1 1 1 1 1 1 5 0 1 0 4 1 1 1 1 5 0 0 0 0 0
0 0 0 0 0 1 1 1 0 1 0 4 1 1 1 1 1 1 1 1 1 1 5 0 1 0 4 1 1 1 1 1 1 1 1 1 1 5 0 1 0 4 1 1 1 1 5 0 0 0 0 0
1 1 1 1 0 1 1 1 0 0 0 12 1 1 1 1 1 1 1 1 1 1 13 0 0 0 12 1 1 1 1 1 1 1 1 1 1 13 0 0 0 12 1 1 1 1 13 0 1 1 1 1
1 1 1 1 0 1 1 1 0 1 0 12 1 1 1 1 1 1 1 1 1 1 13 0 1 0 12 1 1 1 1 1 1 1 1 1 1 13 0 1 0 12 1 1 1 1 13 0 1 1 1 1
1 1 1 1 0 1 1 1 0 1 0 7 11 11 11 11 3 3 11 11 11 11 8 0 1 0 7 11 11 11 11 3 3 11 11 11 11 8 0 1 0 7 11 3 3 11 8 0 1 1 1 1
1 1 1 1 0 0 0 0 0 0 0 0 0 0 0 0 0 0 0 0 0 0 0 0 0 0 0 0 0 0 0 0 0 0 0 0 0 0 0 0 0 0 0 0 0 0 0 0 1 1 1 1
1 1 1 1 0 1 0 1 0 1 0 1 0 1 1 0 1 0 1 0 1 0 1 0 1 0 1 0 1 1 0 1 0 1 0 1 0 1 0 1 0 1 0 1 1 0 1 0 1 1 1 1
1 1 1 1 0 0 0 0 0 0 0 0 0 0 0 0 0 0 0 0 0 0 0 0 0 0 0 0 0 0 0 0 0 0 0 0 0 0 0 0 0 0 0 0 0 0 0 0 1 1 1 1
1 1 1 1 0 6 10 10 10 10 2 2 10 10 10 10 9 0 1 0 6 10 10 10 10 2 2 10 10 10 10 9 0 1 0 6 10 10 10 10 2 2 10 10 10 10 9 0 1 1 1 1
1 1 1 1 0 4 1 1 1 1 1 1 1 1 1 1 5 0 1 0 4 1 1 1 1 1 1 1 1 1 1 5 0 1 0 4 1 1 1 1 1 1 1 1 1 1 5 0 1 1 1 1
1 1 1 1 0 4 1 1 1 1 1 1 1 1 1 1 5 0 1 0 4 1 1 1 1 1 1 1 1 1 1 5 0 1 0 4 1 1 1 1 1 1 1 1 1 1 5 0 1 1 1 1
1 1 1 1 0 7 11 11 11 11 3 3 11 11 11 11 8 0 1 0 7 11 11 11 11 3 3 11 11 11 11 8 0 1 0 7 11 11 11 11 3 3 11 11 11 11 8 0 1 1 1 1
1 1 1 1 0 0 0 0 0 0 0 0 0 0 0 0 0 0 0 0 0 0 0 0 0 0 0 0 0 0 0 0 0 0 0 0 0 0 0 0 0 0 0 0 0 0 0 0 1 1 1 1
1 1 1 1 1 1 1 1 1 1 1 1 1 1 1 1 1 1 1 1 1 1 1 1 1 1 1 1 1 1 1 1 1 1 1 1 1 1 1 1 1 1 1 1 1 1 1 1 1 1 1 1
1 1 1 1 1 1 1 1 1 1 1 1 1 1 1 1 1 1 1 1 1 1 1 1 1 1 1 1 1 1 1 1 1 1 1 1 1 1 1 1 1 1 1 1 1 1 1 1 1 1 1 1
