0 0 0 0 0 0 0 0 0 0 0 0 0 0 0 0 0 0 0 0 0 0 0 0 0 0 0 0 0 0 0 0 0 0 0 0 0 0 0 0 0 0 0 0 0 0 0 0 0 0 0 0 
0 0 0 0 0 0 0 0 0 0 0 0 0 0 0 0 0 0 0 0 0 0 0 0 0 0 0 0 0 0 0 0 0 0 0 0 0 0 0 0 0 0 0 0 0 0 0 0 0 0 0 0 
0 0 0 0 10 1 1 1 1 1 1 1 1 1 1 1 1 6 1 6 1 1 1 1 1 1 1 1 1 1 1 1 6 1 6 1 1 1 1 1 1 1 1 1 1 1 1 13 0 0 0 0 
0 0 0 0 3 0 0 0 0 0 0 0 0 0 0 0 0 4 0 3 0 0 0 0 0 0 0 0 0 0 0 0 3 0 4 0 0 0 0 0 0 0 0 0 0 0 0 4 0 0 0 0 
0 0 0 0 3 0 0 0 0 0 0 0 0 0 0 0 0 4 0 3 0 0 0 0 0 0 0 0 0 0 0 0 3 0 4 0 0 0 0 0 0 0 0 0 0 0 0 4 0 0 0 0 
0 0 0 0 3 0 0 0 0 0 0 0 0 0 0 0 0 4 0 3 0 0 0 0 0 0 0 0 0 0 0 0 3 0 4 0 0 0 0 0 0 0 0 0 0 0 0 4 0 0 0 0 
0 0 0 0 3 0 0 0 0 0 0 0 0 0 0 0 0 4 0 3 0 0 0 0 0 0 0 0 0 0 0 0 3 0 4 0 0 0 0 0 0 0 0 0 0 0 0 4 0 0 0 0 
0 0 0 0 7 1 6 1 6 1 6 1 6 1 1 6 1 5 1 5 2 6 2 6 2 6 2 6 2 2 6 2 5 2 5 1 6 1 6 1 6 1 6 1 1 6 1 9 0 0 0 0 
0 0 0 0 3 0 4 0 3 0 4 0 3 0 0 4 0 3 0 4 0 3 0 4 0 3 0 4 0 0 3 0 4 0 3 0 4 0 3 0 4 0 3 0 0 4 0 4 0 0 0 0 
0 0 0 0 7 2 8 2 5 2 5 2 8 2 2 8 2 8 2 8 1 8 1 5 1 5 1 8 1 1 8 1 8 1 8 2 8 2 5 2 5 2 8 2 2 8 2 9 0 0 0 0 
0 0 0 0 3 0 0 0 4 0 3 0 0 0 0 0 0 0 0 0 0 0 0 3 0 4 0 0 0 0 0 0 0 0 0 0 0 0 3 0 4 0 0 0 0 0 0 4 0 0 0 0 
0 0 0 0 3 0 0 0 4 0 3 0 0 0 0 0 0 0 0 0 0 0 0 3 0 4 0 0 0 0 0 0 0 0 0 0 0 0 3 0 4 0 0 0 0 0 0 4 0 0 0 0 
0 0 0 0 3 0 0 0 7 1 9 0 0 0 0 0 0 0 0 0 0 0 0 7 2 9 0 0 0 0 0 0 0 0 0 0 0 0 7 2 9 0 0 0 0 0 0 4 0 0 0 0 
1 1 1 1 9 0 0 0 3 0 4 0 0 0 0 0 0 0 0 0 0 0 0 4 0 3 0 0 0 0 0 0 0 0 0 0 0 0 4 0 3 0 0 0 0 0 0 7 1 1 1 1 
1 1 1 1 9 0 0 0 3 0 4 0 0 0 0 0 0 0 0 0 0 0 0 4 0 3 0 0 0 0 0 0 0 0 0 0 0 0 4 0 3 0 0 0 0 0 0 7 1 1 1 1 
0 0 0 0 4 0 0 0 7 2 9 0 0 0 0 0 0 0 0 0 0 0 0 7 1 9 0 0 0 0 0 0 0 0 0 0 0 0 7 1 9 0 0 0 0 0 0 3 0 0 0 0 
0 0 0 0 4 0 0 0 4 0 3 0 0 0 0 0 0 0 0 0 0 0 0 3 0 4 0 0 0 0 0 0 0 0 0 0 0 0 3 0 4 0 0 0 0 0 0 3 0 0 0 0 
0 0 0 0 4 0 0 0 4 0 3 0 0 0 0 0 0 0 0 0 0 0 0 3 0 4 0 0 0 0 0 0 0 0 0 0 0 0 3 0 4 0 0 0 0 0 0 3 0 0 0 0 
0 0 0 0 7 1 6 1 5 1 5 1 6 1 1 6 1 6 1 6 2 6 2 5 2 5 2 6 2 2 6 2 6 2 6 1 6 1 5 1 5 1 6 1 1 6 1 9 0 0 0 0 
0 0 0 0 4 0 3 0 4 0 3 0 4 0 0 3 0 4 0 4 0 4 0 3 0 4 0 3 0 0 4 0 3 0 3 0 3 0 4 0 3 0 4 0 0 3 0 3 0 0 0 0 
0 0 0 0 7 2 8 2 8 2 8 2 8 2 2 8 2 5 2 5 1 8 1 8 1 8 1 8 1 1 8 1 5 1 5 2 8 2 8 2 8 2 8 2 2 8 2 9 0 0 0 0 
0 0 0 0 4 0 0 0 0 0 0 0 0 0 0 0 0 3 0 4 0 0 0 0 0 0 0 0 0 0 0 0 4 0 3 0 0 0 0 0 0 0 0 0 0 0 0 3 0 0 0 0 
0 0 0 0 4 0 0 0 0 0 0 0 0 0 0 0 0 3 0 4 0 0 0 0 0 0 0 0 0 0 0 0 4 0 3 0 0 0 0 0 0 0 0 0 0 0 0 3 0 0 0 0 
0 0 0 0 4 0 0 0 0 0 0 0 0 0 0 0 0 3 0 4 0 0 0 0 0 0 0 0 0 0 0 0 4 0 3 0 0 0 0 0 0 0 0 0 0 0 0 3 0 0 0 0 
0 0 0 0 4 0 0 0 0 0 0 0 0 0 0 0 0 3 0 4 0 0 0 0 0 0 0 0 0 0 0 0 4 0 3 0 0 0 0 0 0 0 0 0 0 0 0 3 0 0 0 0 
0 0 0 0 11 1 1 1 1 1 1 1 1 1 1 1 1 8 1 8 1 1 1 1 1 1 1 1 1 1 1 1 8 1 8 1 1 1 1 1 1 1 1 1 1 1 1 12 0 0 0 0 
0 0 0 0 0 0 0 0 0 0 0 0 0 0 0 0 0 0 0 0 0 0 0 0 0 0 0 0 0 0 0 0 0 0 0 0 0 0 0 0 0 0 0 0 0 0 0 0 0 0 0 0 
0 0 0 0 0 0 0 0 0 0 0 0 0 0 0 0 0 0 0 0 0 0 0 0 0 0 0 0 0 0 0 0 0 0 0 0 0 0 0 0 0 0 0 0 0 0 0 0 0 0 0 0